UBX	KEYWORD1	
GPSUBX	KEYWORD1	
GPSNMEA	KEYWORD1	
initialise	KEYWORD2	
read	KEYWORD2
location	KEYWORD2
have_gps	KEYWORD2
status	KEYWORD2
num_sats	KEYWORD2
horizontal_dilution	KEYWORD2
vertical_dilution	KEYWORD2
last_time_fix_ms	KEYWORD2
height	KEYWORD2
heading	KEYWORD2
groundspeed	KEYWORD2
setHilHeading	KEYWORD2


## USE THIS FOR CLASS INITIALISATION ##
NMEAGPS	LITERAL1
UBXGPS	LITERAL1
AP_GPS	KEYWORD1
AP_gps	LITERAL1
_gps	LITERAL1


